1111111111111
10C0000E000C1
1P00000C00111
1000011000011
1111111111111