1111111111111
10C00000000C1
1P00000C00111
1000011000011
1001100001001
1000000011001
1111111111111